111111111111
10E000000001
10000000C001
10000000000P1
111111111111