1111111111111
1010000000101
1000000000001
101E000000101
100C00000C001
1P000X0000001
1111111111111