1111111111111111111111111
1P01111111111111111111111
1C01111111111111111111111
1E01111111111111111111111
1101111111111111111111111
1101111111111111111111111


1101111111111111111111111
1100000000000000000000001
1C1C1C1C1C1C1C1C1C1C1C1C1
1000000000000000000000001
1C0C1C1C1C1C1C1C1C1C1C1C1
1101111111111111111111111


1101111111111111111111111
1100000000000000000000001
1C1C1C1C1C1C1C1C1C1C1C1C1
1000000000000000000000001
1C0C1C1C1C1C1C1C1C1C1C1C1
1101111111111111111111111


1101111111111111111111111
10000001000C00100001C0101
1000100000100000000C01101
1111111111111111111111111

1111111111111111111111111

1111111111111111111111111

1111111111111111111111111

1111111111111111111111111

1111111111111111111111111

1111111111111111111111111

1111111111111111111111111