1111111111111111111111111
1P00000000000000000000001
1C1C1C1C1C1C1C1C1C1C1C1C1
1000000000000000000000001
1C1C1C1C1C1C1C1C1C1C1C1C1
1000000000000000000000001
1C1C1C1C1C1C1C1C1C1C1C1C1
1000000000000000000000001
1C1C1C1C1C1C1C1C1C1C1C1C1
1000000000000000000000001
1C1C1C1C1C1C1C1C1C1C1C1C1
1000000000000000000000001
1C1C1C1C1C1C1C1C1C1C1C1C1
1000000000000000000000001
1C1C1C1C1C1C1C1C1C1C1C1C1
1000000000000000000000001
1C1C1C1C1C1C1C1C1C1C1C1C1
10000000000000000000000E1
1111111111111111111111111