11111111111
101100E1C11
1C101C1C001
101010100C1
1001P110101
101011000C1
10001101101
1100C000001
10100001101
101C1110011
11111111111