1111111111111111111
1010011100110000011
1E10100000000001011
1000P00100011111111
1000111111111111111
1111111111111111111