11111111111
1C0000000C1
10011111001
100100P0001
10011111001
100000C1001
10011111001
1C0000000E1
11111111111
