1111111111111111111111
1C000000000E00000000P1
1C00001111111111000001
1C00010000000000100001
1000100010000100010001
1C00100000000000010001
1C00100011111110010001
1000010000000000100001
1C00001111111111000001
1C00000000000000000001
1111111111111111111111
