111111111111111111111111111111
101001110011C000011EC000010001
100110000000000001000101101011
100010011101010000000000000101
1001000P0010001101100011001111
111000010000001011000110111001
101100000010000011111001000101
100100101000111001000000001111
111001000111100100001010100101
101000010000101001100001010111
111100100011010000010010000111
101000010000001001001011101101
110101110000010010100010010101
111111111111111111111111111111
