111111111111111111111111111111
100001110011C000011EC000010001
100110000000000001000101101011
100000011101010000000000000101
10010000001000110110P011001111
111000010000001011000110111001
101100000010000011111001000101
100100101000111001000000001111
101000101000101111101110101111
111111111111111111111111111111
